1111111111111
1010000001C01
1100001010101
1P0001E000001
1111111111111