1111111111111
10010000000C1
10C0010C11001
1P1011E10C001
1111111111111