1111111111111
1001000000C01
1000011111001
1P00110E00001
1111111111111