1111111111111111111111111111111111
1000C0000000000C00000C000000010001
101001C100100000101001C00000010101
1010010010101010001001000000010101
1C0C00000C00C000000C000000000C01C1
101001C100100000101001C00000010101
1010010010101010001001000000010101
101001C100100000101001C00000010101
1E100100101010100010010000000101P1
1111111111111111111111111111111111