1111111111111111111111111111111111
10C00C0000C00000C0C00C000000010001
10100101001000001010010C0000110C01
1010010010101010001001010101010101
10C00C0000C00000C0000C0000000C0101
1010010100100000101001010101010101
1010010010101010001001000100010101
10100101001000C0101001C01001010101
1E1001001010101000100110001001C1P1
1111111111111111111111111111111111